11111111111111111111111111111
11111000010000000111000000001
1011P00000000000000C000000001
1001000000000000000000000C001
10000000000000100000001000001
10010001000C01100000010000001
10000011000000101000001000001
11100111100000001000000001011
11100011110000001000000011011
11100001110000000000000011011
11100000100000000C00000001011
11100001110000000000100000001
100000011110000000000000E1001
10000001110000000000000010001
10000000111000000000000001001
11111111111111111111111111111
