11111111111111111111111111111111
100000111111000100C0010000000111
10000111111000000000100000001111
100000111011C0001001110000000111
10000001000100001001110000001111
10000000000001000000110000011111
10000001000101000000000000001111
10000000000001000000000000000111
10000100000001000000000000000011
100000000P0000000010000000000011
10E0C000000101000111010001000001
11000100000101100111110000100C01
11101110000001100011110000000001
11111110000011000001100000100001
11111100000001100011110001000001
11111111111111111111111111111111
