1111111111111111111111111111111111
1E0000000000000C00000C000000001111
101001010010000010100100000001
1010010010101010001001000000011111
1P0000000C00C000000000000000011111
1111111111111111111111111111111111
